xxxxxxxxxxxxxxxxxxxxxxxxxxxxxxxx
x                              x
x                              x
x                              x
x                              x
x                              x
x                              x
x                              x
x                              x
x                xxx           x
x                              x
x                              x
x                              x
x                              x
x              xxx             x
x                              x
x                              x
x p                            x
xxxxxxxxxxxxxxxxxxxxxxx   xxxxxx
                                
x                              x
                                
                                
                                